4. August: 
Internationaler Ehrentag der Eule 	(kein Jahr)


[Schülerwohnort 🏫][± [___en: Rechenoperation]chen][G[S___ : Nähmaschine; Bandmitglied; Index für neurologisch Behandlung] ___]r [Gew→___←[unebener Weg mit tiefen ___en]t][["Alt wie ein ___"] in [___bärt wird vermisst]r der [Das 💦 herausbekommen durch ausw___en]e][[___mel = fragwürdig-viel[was Sigmund Freud unabsichtlich tut]der Abwehrjog["👶 dont ___ me no more"]][was [Spitz[vor kurzen im Mathebau getrennt]er]trophoben fürchten]sell[f[___en: anderen zuhören; bespitzeln]iges Tier, jeder schert sich drum doch nur manche wollen es]t Abk.] der [___r: [Aurum][🇩🇪 be[zeigen; analysieren]dster Musiker]s be[weisen; begreifen]dster [früher durch [[beste W[Z___: Nadelbaum aus den Alpen 🌲, bekannt für Möbel, angebliche Heilkräfte oder Schnaps]l[Ob Echsenmenschen da dazuzählen? (Plural)]; Nachname (Plural)] des Jahres 2020, nicht verliebt] verbundene Korrespondenten; entfernte aber enge Bekannte; (Singular)]]




Internat: Schülerwohnort 🏫
ion: ± Teilchen
	Teil: ___en: Rechenoperation
ale: Ginger ___
	inger: S___ : Nähmaschine; Bandmitglied; Index für neurologisch Behandlung
Ehr: Gew -> ___ <- furcht 
	furch: unebener Weg mit tiefen ___en
ent: Baum in Herr der Ringe
	Baum: "Alt wie ein ___"
	Her: ___bärt wird vermisst 
	Ring: Das 💦 herausbekommen durch ausw___en 
ag: Aktiengesellschaft Abk.
	Akti: ___mel = fragwürdig-vielversprechender Abwehrjoghurt
		versprechen: was Sigmund Freud unabsichtlich tut
		hurt: "👶 dont ___ me no more"
	enge: was Klaustrophoben fürchten
		Klaus: Spitzmüller
			Müll: vor kurzen im Mathebau getrennt
	schaf: flauschiges Tier, jeder schert sich drum doch nur manche wollen es
		lausch: ___en: anderen zuhören; bespitzeln
Eule: ___r: Goldbachs bedeutendster Brieffreund
	Gold: Aurum
	Bach: 🇩🇪 bedeutendster Musiker
		deuten: zeigen; analysieren 
	deuten: weisen; begreifen
	Brieffreunde: früher durch Tauben verbundene Korrespondenten; entfernte aber enge Bekannte; (Singular)
		Tauben: Vögel des Jahres 2020, nicht verliebt
			Vögel: beste Wirbeltiere; Nachname (Plural)
				irbe: Z___: Nadelbaum aus den Alpen 🌲, bekannt für Möbel, Heilkräfte oder Schnaps
				Tiere: Ob Echsenmenschen da dazuzählen?	



-----------------------------------------------------------------------------------------------------------------------------------------------------------------------------------


1. August
Ägypten erklärt Elon Musk, dass Pyramiden nicht von Aliens gebaut wurden. (2020)

[Land am [___s: Gänseflieger]] erklärt [[Die Bootgang, Hellapagos oder Hanabi][Zutat für ["___ die mag ich sehr, sie schmecken mir am besten"] die durch auspressen mit Handtuch und trocknen lassen gewonnen wird]]n [[D-___; Grenzgebiet; Zuckerberg] mit Zucker (🍎)]k, dass [___o: ist doch kein Ver[übergeben; trennen; fraktionieren] (De[längster Fluss in 🇮🇳]tri[form___: präzise beschrieben])][Acryl___: Entsteht beim zu heißen f[Mönchhausen auf Kanonenkugel]ieren von [Erdäpfel (Plural)]]en nicht von [[Prophet im Islam] 🥊]ens gebaut wurden.

Ägypten: Land am Nil
	Nil: ___s: Gänseflieger
Elo: Spielstärke
	Spiel: Die Bootgang, Hellapagos oder Hanabi
	Stärke: Zutat für thüringer Klöße die durch auspressen mit Handtuch und trocknen lassen gewonnen wird
		thüringer Klöße: "___ die hab mag ich sehr, sie schmecken mir am besten"
Mus: 🍎 Mark mit Zucker
	Mark: Zuckerberg
Pyr: ___o: ist doch kein Verbrechen (Deindustrialisiert)
	brechen: übergeben; trennen; fraktionieren
	indus: längster Fluss in 🇮🇳
	alisiert: form___: präziese beschrieben
Amid: Acryl___: Entsteht beim zu heißen frittieren von Kartoffeln
	ritt: Mönchhausen auf Kanonenkugel 
	Kartoffeln: Erdäpfel (Plural)
Ali: Muhammand 🥊
	Muhammad: Prophet im Islam

